********.*******************.***********
********.*******************.***********
********.*******************.***********
********.*******************.***********
********.*******************.***********
********.*******************.***********
********.*******************.***********
********.*******************.***********
********.*******************.***********
********.*******************.***********
********.*******************.***********
********.*******************.***********
****************************.***********
****************************.***********
****************************.***********
****************************.***********
**************************...***********
***********************....*.***********
***********************.****.***********
***********************..***.***********
********...............*.***.***********
********.***************.***.***********
********.***************.***.***********
********.................***.***********
********.*******************.***********
********.***********.........***********
********.*******************.***********
********....................************
********.*******************.***********
********.*******************.***********
********.*******************.***********
********.*******************.***********
********.*******************.***********
*******..*******************.***********
********.*******************.***********
********.*******************.***********
********.*******************.***********
********.*******************.***********
********.*******************.***********
********.*******************.***********
\robot 8 0
\robot 8 1